001
XXXXXXXXXXXXXXX--XXXXXXXXXXXXXXX
XX----------------------------XX
XX----------------------------XX
XX----------------------------XX
XX----------------------------XX
XX----------------------------XX
XX----------------------------XX
XX----------------------------XX
XX----------------------------XX
XX||---||||||||||||||||||---||XX
XX----------------------------XX
XX----------------------------XX
XX----------------------------XX
XX----------------------------XX
XX||---||||||||||||||||||---||XX
XX----------------------------XX
XX----------------------------XX
XX----------------------------XX
XX----------------------------XX
XX||---||||||||||||||||||---||XX
XX----------------------------XX
XX----------------------------XX
XX----------------------------XX
XX----------------------------XX
XXXXXXXXXXXXXXXXXXXXXXXXXXXXXXXX
