002
XXXXXXXXXXXXXXX--XXXXXXXXXXXXXXX
XX----------------------------XX
XX----------------------------XX
XX----------------------------XX
XX----------------------------XX
XX-----------||||||-----------XX
XX----------------------------XX
XX----------------------------XX
XX----------------------------XX
XX----------------------------XX
XX---------||||--||||---------XX
XX----------------------------XX
XX----------------------------XX
XX----------------------------XX
XX----------------------------XX
XX-----||||||||||||||||||-----XX
XX----------------------------XX
XX----------------------------XX
XX----------------------------XX
XX----------------------------XX
XX--|||||||--||||||--|||||||--XX
XX----------------------------XX
XX----------------------------XX
XX-P------------------------P-XX
XX----------------------------XX
XXXXXXXXXXXXXXXXXXXXXXXXXXXXXXXX
