004
XXXXXXXXX----XX--XX----XXXXXXXXX
XX------X--------------X------XX
XX------X||----------||X------XX
XX----------------------------XX
XX----E------------------E----XX
XX----------------------------XX
XX---X||||||XX----XX||||||X---XX
XX---X------XX----XX------X---XX
XX---X-E----XX----XX----E-X---XX
XX---X------XX----XX------X---XX
XX---X|||---XX----XX---|||X---XX
XX----------XX----XX----------XX
XX----------XX----XX----------XX
XX----------XX----XX----------XX
XX----------XX----XX----------XX
XX---X|||--------------|||X---XX
XX---X--------------------X---XX
XX---X--------------------X---XX
XX---X----E----------E----X---XX
XX---X--------------------X---XX
XX---X||||||---||---||||||X---XX
XX----------------------------XX
XX----------------------------XX
XX-P------------------------P-XX
XX----------------------------XX
XXXXXXXXX----XXXXXX----XXXXXXXXX