005
XXXXXXXXX----XX--XX----XXXXXXXXX
XX----------------------------XX
XX----------------------------XX
XX----------------------------XX
XX----X------------------X----XX
XX----X-|||||||||||||||||X----XX
XX----------------------------XX
XX----------------------------XX
XX----------------------------XX
XX----X------------------X----XX
XX----X|||||||||||||||||-X----XX
XX----------------------------XX
XX----------------------------XX
XX----------------------------XX
XX----X------------------X----XX
XX----X-|||||||||||||||||X----XX
XX----------------------------XX
XX----------------------------XX
XX----------------------------XX
XX----X------------------X----XX
XX----X||||||||--||||||||X----XX
XX----------------------------XX
XX----------------------------XX
XX-P------------------------P-XX
XX----------------------------XX
XXXXXXXXX----XXXXXX----XXXXXXXXX